{
  "id": "testing-grounds",
  "name": "Testing Grounds",
  "tiles": [
    "################################################",
    "#..............................................#",
    "#..............................................#",
    "#..............................................#",
    "#..............................................#",
    "#..............................................#",
    "#.........................D....................#",
    "#..............................................#",
    "#..............................................#",
    "#......................................####....#",
    "#..............................................#",
    "#.................................####.........#",
    "#...................#..........................#",
    "#.....######........#........####..............#",
    "#.....######........#..........................#",
    "#...................#...####...................#",
    "#..S............D...#.......................D..#",
    "################################################"
  ]
}
