{
  "id": "testing-grounds",
  "name": "Testing Grounds",
  "tiles": [
    "################################################",
    "#..............................................#",
    "#..............................................#",
    "#..............................................#",
    "#..............................................#",
    "#..............................................#",
    "#.........................D....................#",
    "#..............................................#",
    "#..............................................#",
    "#..............................................#",
    "#..............................................#",
    "#..............................................#",
    "#...................#..........................#",
    "#.....######........#..........................#",
    "#.....######........#..........................#",
    "#...................#..........................#",
    "#..S............D...#.......................D..#",
    "################################################"
  ],
  "shapes": [
    {
      "id": "ramp",
      "kind": "polygon",
      "solidity": "solid",
      "points": [[22, 17], [38, 17], [38, 14], [32, 14]]
    },
    {
      "id": "tilted",
      "kind": "rect",
      "solidity": "solid",
      "pos": [10, 10.5],
      "size": [4, 0.5],
      "rotation": 20
    },
    {
      "id": "glass-deck",
      "kind": "polyline",
      "solidity": "glass",
      "points": [[23, 11.5], [30, 11.5]],
      "tint": "#9fe8ff"
    },
    {
      "id": "bowl",
      "kind": "arc",
      "solidity": "solid",
      "center": [42.5, 9.5],
      "radius": 4.5,
      "startDeg": 150,
      "endDeg": 30
    }
  ]
}
